151 29
                                                                                                                                                       
                                                                                                                                                       
                                                                                                                                                       
                                                                                                                                                       
                                                                                                                                                       
                                                                                                                                                       
                                                                                                                                                       
                                                                                                                                                       
                                                                                                                                                       
                                                                                                                                                       
                                                                                                                                                       
                                                                                                                                                       
                                                                                                                                         11111111      
                                                                                                                                       1111            
                                                                                                                                    11111111           
                                                                                                                                 11111111              
                                                                                                                               1111         111111     
                                                      111111111111                                                            1111                     
                                                     1         1111                                                          1111                      
                                                               11111111                                                    1111                        
                                                 1                11111111                                           11111111                          
                                             1                                                                     1111                                
                                                                                                                1111                        1111       
                                        11                                                                     1111                                    
                                                                                                             1111                                      
                                    11                                         1                           1111                                        
                                1                                        1           11                  1111                                          
                            1                                            1                             1111                                            
111111111111111111111111111111                               1          11                        1111111111111111111111111111111111111                
0
141 7
42 2
