151 29
                                                                                                                                                       
                                                                                                                                                       
                                                                                                                                                       
                                                                                                                                                       
                                                                                                                                                       
                                                                                                                                                       
                                                                                                                                                       
                                                                                                                                                       
                                                                                                                                                       
                                                                                                                                                       
                                                                                                                                              11111    
                                                                                                                                            111        
                                                                                                                                         111           
                                                                                                                                       1111            
                                                                                                                                    11111111           
                                                                                                                                 11111111   1    1     
                                                                                                                               1111         111111     
                                                      111111111111                                                            1111                     
                                                   1111        1111                                                          1111                      
                                                1111           11111111                                                    1111                        
                                              1111                11111111                                           11111111                          
                                            1111                                                                   1111                                
                                          1111                                                                  1111                        1111       
                                        1111                                                                   1111                                    
                                      1111                                                                   1111                                      
                                  1111                                         1                           1111                                        
                              1111                                       1           11                  1111                                          
                            1111                                         1                        1    1111                                            
11111111111111111111111111111111111111111111111111111111111111111111111111                        1111111111111111111111111111111111111                
0
141 7
42 2
9
1 26 1
1 68 11 
1 71 9
1 72 1
5 72 1
2 72 1
3 117 1
1 125 1
5 144 13
0